NO ./textures/wall_n.png
SO ./textures/wall_s.png
WE ./textures/wall_w.png
EA ./textures/wall_e.png

R 1280 720
S ./textures/speed.png
F 90,90,90
C 225,225,225

111111111111
100200000001
100020000001
1000000000S1
100000000001
100000000001
111111111111