NO ./textures/wall_n.png
SO ./textures/wall_s.png
WE ./textures/wall_w.png
EA ./textures/wall_e.png

R 800 600
S ./textures/sprite.png
F 220,100,0
C 225,30,0

       11111111111
       10000000001111111111111
       10000000001000000000001
       10000200001000000000001
       10000000001000000000001
       1000011000100000N000001
       10000110001000000000001
       10000000001000000000001
       11100000111111002000111
111111110000000000000000000001
100000000001100000000200000001
10000000000110000000000000000111
111110111111111111111011111111
  10000001        1100011
  10000001        1100011
  11111111        1111111
