NO ./textures/wall_n.png
SO ./textures/wall_s.png
WE ./textures/wall_w.png
EA ./textures/wall_e.png

R 1280 720
S ./textures/speed.png
F 90,90,90
C 225,225,225

  11111   1111
  10001   1001
1110001111100111
1000001   10S001
1110001111100001
  100000000001
  111111111111