NO ./textures/wall_n.png
SO ./textures/wall_s.png
WE ./textures/wall_w.png
EA ./textures/wall_e.png

R 1280 720
S ./textures/speed.png
F 90,90,90
C 225,225,225

  11111   1111
  10001   1221
1110001111102111
1000001   10W001
1110001111100001
  100000002001
  111111111111