NO ./textures/wall_n.png
SO ./textures/wall_s.png
WE ./textures/wall_w.png
EA ./textures/wall_e.png

R 1280 720
S ./textures/speed.png
F 90,90,90
C 225,225,225

11111111                   111111111111111111111111111
10S00001                   100000100001       10000001
100000011111111111111111111100000100001       10000001
100000000000000000000000000000000110111       10000001
100000011111111111111111111100000000001       11100111
10000001                   111110000001         1001
1111100111111111111111111111111111110011111111111001
    100000111111111111110000000000000000000000000001
    111110000000000000000000000000000011111111111111
    111110000000000000000000000000000011111111111111
    111111111111111111111111111111111111111111111111