NO ./textures/wall_n.xpm
SO ./textures/wall_s.xpm
WE ./textures/wall_w.xpm
EA ./textures/wall_e.xpm

R 1280 720
S ./textures/speed.xpm
F 90,90,90
C 225,225,225

111111111111
100200000001
100011110001
10001  100S1
100011110001
100000000001
111111111111