NO ./textures/wall_n.xpm
SO ./textures/wall_s.xpm

WE ./textures/wall_w.xpm
EA ./textures/wall_e.xpm

R 4020 3020

F 90,90,90
C 225,225,225

S ./textures/speed.xpm



11111111                   111111111111111111111111111
10S00001                   100000100001       10000001
100000011111111111111111111100000100001       10000001
100300000000000000000000000000000110111       10000001
100200011111111111111111111100000000001       11100111
10000001                   111110000001         1001
1111102111111111111111111111111111110011111111111001
    100000111111111111110000000000000000000000000001
    111110000000000000000000000000000011111111111111
    111110000000000000000000000000000011111111111111
    1111111111110011111111111111111111111
    1111111111110011111111111111111111111
    1111111111110011111111111111111111111
    1111111111110011111111111111111111111
    1111111111110011111111111111111111111
    1111111111110011111111111111111111111
    1111111111110011111111111111111111111
    1111111111110011111111111111111111111
	1000000000000000000000000000001
	1000000000000000000000000000001
	1000000000000000000000000000001
	1000000000000000000000000000001
	1000000000000000000000000000001
11111111111111111111111000111111111
1000000000000000000000000000001
1000000000000000000000000000001
1000000000000000000000000000001
100000000000000000000000000000111111111111111111111111111111111
100000000000000000000000000000000000000000000000000000000000001111
111111111111111111111111111111111111100000000000000000000000000001
                                    111111111111111111111111111111