NO ./textures/wall_n.xpm
SO ./textures/wall_s.xpm
WE ./textures/wall_w.xpm
EA ./textures/wall_e.xpm
R 720 360
F 90,90,90
C 225,225,225
S ./textures/sprite.xpm

1111
1  1
1 N1
1111