NO ./textures/wall_n.xpm
SO ./textures/wall_s.xpm
WE ./textures/wall_w.xpm
EA ./textures/wall_e.xpm

R 1280 720
S ./textures/speed.xpm
F 90,90,90
C 225,225,225

11111   1111
10001   1001
100011111001
10001   10S1
100011111001
10001   1001
11111   1111