NO ./textures/wall_n.xpm
SO ./textures/wall_s.xpm
WE ./textures/wall_w.xpm
EA ./textures/wall_e.xpm

R 1280 720
S ./textures/sprite.xpm
F 90,90,90
C 225,225,225

  11111   1111
  1   1   1221
111   11111 2111
1     1   1 W  1
111   11111  111
  1   11111  1
  1111     11
