NO ./textures/wall_n.xpm
SO ./textures/wall_s.xpm
WE ./textures/wall_w.xpm
EA ./textures/wall_e.xpm

R 1280 720
S ./textures/speed.xpm
F 90,90,90
C 225,225,225

11111111111111
10001     1001
10001111111001
10000000000001
11111110011111
      1001
      1001
   11110N111
   111111111